88 88 88 88 88 88 88 88 88 88 88 88 88 88 88 88 88 88 88 88
4 4 4 4 4 4 4 4 4 4 4 4 4 4 4 4 4 4 4 4
4 9 9 9 9 9 9 9 9 9 9 9 9 9 9 9 9 9 4 4
4 0 0 0 0 0 0 0 0 0 0 2 0 0 0 0 0 0 6 4
4 0 4 4 4 4 4 4 4 4 4 4 4 0 0 4 4 0 0 4
4 0 4 9 9 9 9 9 9 9 9 9 7 0 0 4 4 0 3 4
4 0 4 0 0 0 0 0 0 0 0 0 0 0 0 4 4 4 4 4
4 0 4 4 4 0 4 4 4 4 4 4 4 4 0 4 4 9 4 4
4 0 6 9 7 0 6 9 9 9 9 4 9 7 0 6 9 0 4 4
4 0 0 0 0 0 0 0 0 0 0 4 0 0 0 0 0 0 4 4
4 0 4 4 4 4 4 4 4 4 4 4 4 0 0 4 4 0 4 4
4 0 9 9 4 9 9 9 9 4 9 9 9 0 0 4 4 0 9 4
4 0 0 0 9 0 0 0 0 9 0 0 0 0 0 4 4 0 0 4
4 0 0 0 0 0 0 0 0 0 0 0 0 0 0 4 4 0 1 4
4 4 4 4 4 4 4 4 4 4 4 4 4 4 4 4 4 4 4 4