88 88 88 88 88 88 88 88 88 88 88 88 88 88 88 88 88 88 88 88
17 15 15 15 15 15 15 15 15 15 15 15 15 15 15 15 15 15 17 17
16 12 12 12 12 12 12 12 12 12 12 12 12 12 12 12 12 12 19 17
16 0 0 0 0 0 0 0 0 0 0 2 0 0 0 0 0 0 8 16
16 0 18 15 15 15 15 15 15 15 15 15 13 0 0 18 20 0 0 16
16 0 16 12 12 12 12 12 12 12 12 12 14 0 0 16 16 0 6 16
16 0 16 0 0 0 0 0 0 0 0 0 0 0 0 16 10 15 15 17
16 0 19 15 13 0 7 15 15 15 15 15 15 13 0 19 21 12 16 17
16 0 8 12 14 0 8 12 12 12 12 16 12 14 0 8 14 0 16 17
16 0 0 0 0 0 0 0 0 0 0 16 0 0 0 0 0 0 16 17
16 0 7 15 15 15 15 15 15 15 15 10 13 0 0 18 20 0 19 17
16 0 12 12 11 12 12 12 12 11 12 12 14 0 0 16 16 0 8 16
16 0 0 0 12 0 0 0 0 12 0 0 0 0 0 16 16 0 0 16
16 0 0 0 0 0 0 0 0 0 0 0 0 0 0 16 16 0 1 16
17 15 15 15 15 15 15 15 15 15 15 15 15 15 15 15 15 15 15 17