0 0 0 0 0 0 0 0 0 0 0 0 0 0 0 0 0 0 0 0
4 4 4 4 4 4 4 4 4 4 4 4 4 4 4 4 4 4 4 4
4 9 9 9 9 9 9 9 9 9 9 9 9 9 9 9 9 9 4 4
4 0 0 0 0 0 0 0 0 0 0 0 0 0 0 0 0 0 9 4
4 0 4 4 4 4 4 4 4 4 4 4 4 0 0 4 4 0 0 4
4 0 4 9 9 9 4 9 9 9 9 9 9 0 0 4 4 2 3 4
4 0 4 0 0 0 4 0 0 0 0 0 0 0 0 4 4 4 4 4
4 0 4 4 4 0 4 4 4 4 4 4 4 4 0 4 4 9 4 4
4 0 9 9 9 0 4 9 9 9 9 4 9 9 0 9 9 0 4 4
4 0 0 0 0 0 4 0 0 0 0 4 0 0 0 0 0 0 4 4
4 0 4 4 4 4 4 4 4 4 4 4 4 0 0 4 4 0 4 4
4 0 9 9 4 9 4 9 9 4 9 9 9 0 0 4 4 0 9 4
4 0 0 0 9 0 4 0 0 9 0 0 0 0 0 4 4 0 0 4
4 0 0 0 0 0 4 0 0 0 0 0 0 0 0 4 4 0 0 4
4 4 4 4 4 4 4 4 4 4 4 4 4 4 4 4 4 4 4 4